
 RRRRRRRRRRRRRRRRRRRRRRRRRRRRDD
 RRRRRRRRRRRRRRRRRRRRRRRRRRRRDD
 UU                          DD
 UU RRRRRRRRRRRRRRRRRRRRRRDD DD
 UU RRRRRRRRRRRRRRRRRRRRRRDD DD
 UU UU                    DD DD
 UU UU RRRRRRRRRRRRRRRRDD DD DD
 UU UU RRRRRRRRRRRRRRRRDD DD DD
 UU UU UU              DD DD DD
 UU UU UU RRRRRRRRRRDD DD DD DD
 UU UU UU RRRRRRRRRRDD DD DD DD
 UU UU UU UU        DD DD DD DD
 UU UU UU UU RRRDD  DD DD DD DD
 UU UU UU UU UU DD  DD DD DD DD
 UU UU UU UU UU DD  DD DD DD DD
 UU UU UU UU UU DD  DD DD DD DD
 UU UU UU UU UU DD  DD DD DD DD
 UU UU UU UU UU DD  DD DD DD DD
 UU UU UU UU UU     DD DD DD DD
 UU UU UU UU UULLLLLLL DD DD DD
 UU UU UU UU UULLLLLLL DD DD DD
 UU UU UU UU           DD DD DD
 UU UU UU UULLLLLLLLLLLLL DD DD
 UU UU UU UULLLLLLLLLLLLL DD DD
 UU UU UU                 DD DD
 UU UU UULLLLLLLLLLLLLLLLLLL DD
 UU UU UULLLLLLLLLLLLLLLLLLL DD
 UU UU                       DD
RUU UULLLLLLLLLLLLLLLLLLLLLLLLL
RUU UULLLLLLLLLLLLLLLLLLLLLLLLL


 
