
RRRRRRRRRRRRRRRRRRRRRRRRRRRRRRR
RRRRRRRRRRRRRRRRRRRRRRRRRRRRRRR
 DD UU DD UU DD UU DD UU DD UU
 DD UU DD UU DD UU DD UU DD UU
 DD UU DD UU DD UU DD UU DD UU
 DD UU DD UU DD UU DD UU DD UU
 DD UU DD UU DD UU DD UU DD UU
 DD UU DD UU DD UU DD UU DD UU
 DD UU DD UU DD UU DD UU DD UU
 DD UU DD UU DD UU DD UU DD UU
 DD UU DD UU DD UU DD UU DD UU
 DD UU DD UU DD UU DD UU DD UU
 DD UU DD UU DD RRUUD UU DD UU
 DD UU DD UU DD RRUUD UU DD UU
 DD UU DD UU DRRUU DD UU DD UU
 DD UU DD UU DRRUU DD UU DD UU
 DD UU DD UURRUUUU DD UU DD UU
 DD UU DD UURRUUUU DD UU DD UU
 DD UU DD RRUUD UU DD UU DD UU
 DD UU DD RRUUD UU DD UU DD UU
 DD UU DRRUU DD UU DD UU DD UU
 DD UU DRRUU DD UU DD UU DD UU
 DD UURRUUUU DD UU DD UU DD UU
 DD UURRUUUU DD UU DD UU DD UU
 DD RRUUD UU DD UU DD UU DD UU
 DD RRUUD UU DD UU DD UU DD UU
 DRRUU DD UU DD UU DD UU DD UU
 DRRUU DD UU DD UU DD UU DD UU
RRUUUU DRRUU DRRUU DRRUU DRRUU
RRUURU RRRRU RRRRU RRRRU RRRRU
