
RRRRRRRRRRRRRRRRRRRRRRRRRRRRRRR
RRRRRRRRRRRRRRRRRRRRRRRRRRRRRRR
 DD UU DD UU DD UU DD UU DD UU
 DD UU DD UU DD UU DD UU DD UU
 DD UU DD UU DD UU DD UU DD UU
 DD UU DD UU DD UU DD UU DD UU
 DD UU DD UU DD UU DD UU DD UU
 DD UU DD UU DD UU DD UU DD UU
 DD UU DD UU DD UU DD UU DD UU
 DD UU DD UU DD UU DD UU DD UU
 DD UU DD UU DD UU DD UU DD UU
 DD UU DD UU DD UU DD UU DD UU
 DD UU DD UU DD UU DD UU DD UU
 DD UU DD UU DD UU DD UU DD UU
 DD UU DD UU DD UU DD UU DD UU
 DD UU DD UU DD UU DD UU DD UU
 DD UU DD UU DD UU DD UU DD UU
 DD UU DD UU DD UU DD UU DD UU
 DD UU DD UU DD UU DD UU DD UU
 DD UU DD UU DD UU DD UU DD UU
 DD UU DD UU DD UU DD UU DD UU
 DD UU DD UU DD UU DD UU DD UU
 DD UU DD UU DD UU DD UU DD UU
 DD UU DD UU DD UU DD UU DD UU
 DD UU DD UU DD UU DD UU DD UU
 DD UU DD UU DD UU DD UU DD UU
 DD UU DD UU DD UU DD UU DD UU
 DD UU DD UU DD UU DD UU DD UU
 DRRUU DRRUU DRRUU DRRUU DRRUU
 RRRRU RRRRU RRRRU RRRRU RRRRU
